#############################
#@   #                    ###
#### # ############# ## #####
##   #  ##       ### ##    ##
## #### ## # ### ### #  ## ##
##      #  # ###     ##### ##
### ######## ################
    #   #### ###          ###
### ### #### ### ### #### ###
#    ## #### ### ### #  # ###
### ### ####     ###   ## ###
###       ########## ####    
#############################
