#####
#@  #
### #
#   #
#####
